F 76,76,76
C 99,99,99

NO textures/simonkraft/cobblestone.xpm
SO textures/simonkraft/cobblestone_01.xpm
WE textures/simonkraft/mossy_cobblestone1.xpm
EA textures/simonkraft/cobblestone_02.xpm

111111111111111111
100100100100100001
101100000100000001
100100100111110001
100111100000100001
100000000000001001
100111111111101001
1111000000000N0001
100000000100000001
111111111111111111
