F 76,76,76
C 99,99,99

NO textres/image2.xpm
SO textres/hedge.xpm
WE textres/image2.xpm
EA textres/hedge.xpm
         
1AAAAAAAAAAAAAAAAA1
A00A00A00A00A00000A
A00A00000000000A00A
A00000000000000000A
AAAAAAAAAHAAAAAAAAA
A0000000A0A0000A00A
AHAAAAAAAHAAAA0000A
A00000000000000000A
A00000000N00000000A
1AAAAAAAAAAAAAAAAA1
  