F 76,76,76
C 99,99,99

NO textres/image2.xpm
SO textres/hedge.xpm
WE textres/image2.xpm
EA textres/hedge.xpm

1111111111111111111
10S1001001001000001
1001000000000001001
1000000000000000001
1111111AAHAA1111111
1000000010100001001
100111111H111001001
1111000000000001011
1000000000000000001
111111111A111111111
