F 76,76,76
C 99,99,99

NO textres/image2.xpm
SO textres/hedge.xpm
WE textres/image2.xpm
EA textres/hedge.xpm

A111111111111111111
10S1001001001000001
1001000000000001001
1000000000000000001
1111111AAHAA1111111
100000001010000100A
100111111H11100100A
1AHA00000000000101A
100000000000000000A
111111111A1111111AA
