NO textres/image1.xpm
EA textres/image2.xpm
SO textres/image4.xpm
WE textres/image3.xpm

F 50,50,3 
C 0,40,40 

111111111111111
1111110S0111111
111110000011111
111100000001111
111000000000111
110000000000011
1000000A0000001
110000A1A000011
1110000A0000111
111100000001111
111110000011111
111111000111111
111111111111111
