NO textres/image1.xpm
EA textres/image2.xpm
SO textres/image4.xpm
WE textres/image3.xpm


F 48, 69, 12
C 27, 11, 99       

11111
10S01
10001
10001
10001
10001
10001
10001
10001
10001
10001
10001
11111
