NO textres/image1.xpm
EA textres/image2.xpm
SO textres/image4.xpm
WE textres/image3.xpm


F 50,50,50
C 100,20,20         

11111
10S01
10001
10001
10001
10001
10001
10001
10001
10001
10001
10001
11111
