NO textres/image1.xpm
EA textres/image2.xpm
SO textres/image4.xpm
WE textres/image3.xpm


F 1,100,20
C 15,100,200

11111
11S11
10001
10001
10001
10001
10001
10001
10001
10001
10001
10001
11111
