NO textres/image1.xpm
EA textres/image2.xpm
SO textres/image4.xpm
WE textres/image3.xpm

F 80,90,3 
C 0,60,122 

111111111111111
111111000111111
111110000011111
111100000001111
111000000000111
11000000N000011
100001111100001
110000111000011
111000010000111
111100000001111
111110000011111
111111000111111
111111111111111
