NO ./path_to_the_north_texture.xpm                  
SO ./path_to_the_south_texture.xpm
WE ./path_to_the_west_texture.xpm
EA ./path_to_the_east_texture.xpm

F 220,100,0
C 225,30,0

1111111111
1000000001
101D100001
1000010001
100N000001
1000000001
1111111111
